{ 
"1": "1",
"2": "2", 
"3": "3", 
"4": "4", 
"5": "5", 
"7": "7", 
"8": "8", 
"9": "9", 
"0": "0", 
"6" : "6", 
"10": "10",
"11": "11"
}
