{ 
"1": "1",
"2": "1", 
"3": "1", 
"4": "1", 
"5": "2", 
"7": "2", 
"8": "2", 
"9": "2", 
"0": "3", 
"6" : "3", 
"10": "3",
"11": "3"
}
