{ 
"1": "0",
"2": "0", 
"3": "0", 
"4": "0", 
"5": "1", 
"7": "1", 
"8": "1", 
"9": "1", 
"0": "2", 
"6" : "2", 
"10": "2",
"11": "2"
}
